Tiles
64x64
................C999999999999999999G....C9999999999G...455555555556.........................................................XX..................
.......................................................455555555556..........................KNNNNK.........................XX..................
.................NNNNNNNNNNNNNNNNNN....................455555555556........................DEEEEEEEF........................XX..................
................12222222222222222223.....KKKKKKKKK.....C9999999999G.........................................................XX..................
................C999999999999999999G....12222222223.................................................................LL......XX..................
........................................C999999999G........LL..............LL.......................................LL......XX..................
..................................LL.......................LL..........KKKKLL.............LL........................LL......XX..................
..................KKKKKMK.KKKKKKKKLL....................KKKLLKKKN....DEEEEEEEF....KK......LLM....................LLLLL......XX..................
.K.K.KKKKK.K....DEEEEEEEEEEEEEEEEEEEF....KKKK.N.KK.....122222222223..............DEEEF...DEEEF.....KK.N...KKKKKK.LLLLL..KK..XX..................
DEEEEEEEEEEEF...........................DEEEEEEEEEEF...C9999999999G..............................DEEEEEEEEEEEEEEEEEEEEEEEEEEEEEF................
HHHHHHHHHHHHHHHHHHHHHHHHHHHHHHHHHHHHHHHHHHHHHHHHHHHHHHHHHHHHHHHHHHHHHHHHHHHHHHHHHHHHHHHHHHHHHHHHHHHHHHHHHHHHHHHHHHHHHHHHHHHHHHHHHHHHHHHHHHHHHHHH
IIIIIIIIIIIIIIIIIIIIIIIIIIIIIIIIIIIIIIIIIIIIIIIIIIIIIIIIIIIIIIIIIIIIIIIIIIIIIIIIIIIIIIIIIIIIIIIIIIIIIIIIIIIIIIIIIIIIIIIIIIIIIIIIIIIIIIIIIIIIIIII